988 988 988 988 988 988 988 988 988 988 988 988 988 988 988 988 988 830 830 830 990 0 0 0 0 0 0 0 0 0 0
988 988 779 779 779 779 779 779 779 779 779 779 779 779 988 988 988 830 830 830 990 0 0 0 0 0 0 0 0 0 0
988 988 779 74 74 74 74 74 74 74 74 74 74 779 988 988 988 830 830 830 990 0 0 0 0 0 0 0 0 0 0
988 988 779 74 74 74 74 74 74 74 74 74 74 779 988 988 988 830 830 830 990 0 0 0 0 0 0 0 0 0 0
988 988 779 74 74 63 63 63 63 63 63 74 74 779 988 988 990 830 830 830 990 0 0 0 124 0 0 0 0 0 0
988 988 779 74 74 63 138 138 138 138 63 74 74 779 988 988 990 830 830 830 990 0 0 0 0 0 0 0 0 0 0
988 988 779 74 74 63 138 121 121 138 63 74 74 779 988 990 990 830 830 830 990 0 0 0 0 0 0 0 0 0 0
988 988 779 74 74 63 138 138 138 138 63 74 74 779 988 990 990 830 830 830 990 0 0 0 0 124 0 0 0 0 0
988 988 779 74 74 63 63 63 63 63 63 74 74 779 988 990 990 830 830 830 990 0 0 0 0 0 0 0 0 0 0
988 988 779 74 74 74 74 74 74 74 74 74 74 779 988 988 990 830 830 121 990 0 0 0 124 0 0 0 0 0 0
988 988 779 74 74 74 74 74 74 74 74 74 74 779 988 988 990 830 830 121 990 0 0 0 0 0 0 0 0 0 0
988 988 779 779 779 779 779 779 779 779 779 779 779 779 988 988 990 830 830 830 990 0 0 0 0 0 0 0 0 0 0
988 988 988 988 988 988 988 988 988 988 988 988 988 988 988 988 990 830 830 830 990 0 0 0 124 0 0 0 0 0 0
988 988 988 988 988 988 988 988 988 988 988 988 988 988 988 988 988 830 830 830 990 0 0 107 0 0 0 0 0 0 0
854 854 854 854 854 854 854 854 854 854 854 854 854 854 854 854 854 830 830 830 990 0 0 107 124 124 0 0 0 0 0
854 854 854 854 854 854 854 854 854 854 854 854 854 854 854 854 854 830 830 830 990 0 0 0 107 0 0 124 0 0 0
854 854 854 854 854 854 854 854 854 854 854 854 854 854 854 854 854 830 830 830 990 0 0 0 0 0 0 0 0 0 0
854 854 854 854 854 854 854 854 854 854 854 854 854 854 854 854 854 830 830 830 990 0 0 107 0 124 0 124 0 0 0
854 854 854 854 854 854 854 854 854 854 854 854 854 854 854 854 854 830 830 830 990 0 124 124 0 0 0 0 0 0 0
0 0 0 0 0 0 0 0 0 0 0 0 0 0 0 0 0 0 0 0 0 0 0 0 0 0 0 0 0 0 0
