407 407 407 16 16 16 16 16 16 16 16 16 16 16 988 16 988 16 16 16 990 16 16 16 16 16 16 16 16 16 16
407 407 407 779 16 779 779 16 779 16 16 779 16 779 286 16 16 830 16 830 990 16 16 0 16 0 16 16 0 16 16
407 407 407 16 16 74 16 74 74 16 74 74 16 779 286 16 988 830 830 16 16 0 0 16 0 0 16 16 0 16 16
407 407 407 74 74 74 74 74 74 74 74 74 74 779 286 286 988 830 830 830 990 0 0 0 0 0 0 0 0 0 0
407 407 407 74 74 63 63 63 63 63 63 74 74 779 286 988 990 830 830 830 990 0 0 0 124 0 0 0 0 0 0
407 407 407 74 74 63 138 138 138 138 63 74 74 779 988 286 990 830 830 830 990 0 0 0 0 0 0 0 0 0 0
407 407 407 74 74 63 138 121 121 138 63 74 74 779 988 286 990 830 830 830 990 0 0 0 0 0 0 0 0 0 0
407 407 407 74 74 63 138 138 138 138 63 74 74 779 988 286 990 830 830 830 990 0 0 0 0 124 0 0 0 0 0
407 407 407 74 74 63 63 63 63 63 63 74 74 779 286 990 990 830 830 830 990 0 0 0 0 0 0 0 0 0 0
407 407 407 74 74 74 74 74 74 74 74 74 74 779 988 286 990 830 830 121 990 0 0 0 124 0 0 0 0 0 0
407 407 407 407 74 74 203 203 74 74 74 74 74 779 286 286 990 830 830 121 990 0 0 0 0 0 0 0 0 0 0
407 407 407 407 779 779 203 203 779 779 779 779 779 286 286 286 286 830 830 830 990 0 0 0 0 0 0 0 0 0 0
407 407 407 407 286 286 286 286 286 286 286 286 286 286 286 988 286 830 830 830 990 0 0 0 124 0 0 0 0 0 0
407 407 286 988 286 988 286 286 286 286 286 286 286 286 286 286 286 830 830 830 990 0 0 107 0 0 0 0 0 0 0
407 407 407 407 854 854 854 854 854 854 854 854 854 854 854 854 854 830 830 830 990 0 0 107 124 124 0 0 0 0 0
407 407 407 854 854 854 854 854 854 854 854 854 854 854 854 854 854 830 830 830 990 0 0 0 107 0 0 124 0 0 0
407 407 407 854 854 854 854 854 854 854 854 854 854 854 854 854 854 830 830 830 990 0 0 0 0 0 0 0 0 0 0
407 407 407 854 854 854 854 854 854 854 854 854 854 854 854 854 854 830 830 830 990 0 0 107 0 124 0 124 0 0 0
407 407 407 854 854 854 854 854 854 854 854 854 854 854 854 854 854 830 830 830 990 0 124 124 0 0 0 0 0 0 0
407 407 407 0 0 0 0 0 0 0 0 0 0 0 0 0 0 0 0 0 0 0 0 0 0 0 0 0 0 0 0
