0 0 0 0 0 0 0 0 0 0 74 0 0 0 0 0 0 0 0 0 0 0 0 0 0 0 0 0 0 0 0
0 0 0 0 0 0 0 0 0 0 0 74 0 0 0 0 0 0 0 0 0 0 0 0 0 0 0 0 0 0 0
0 0 0 0 0 0 0 0 74 0 0 74 0 74 0 0 0 0 74 0 0 0 0 0 0 0 0 0 0 0 0
74 0 0 0 0 5 0 0 74 0 0 74 0 0 1 0 0 0 0 74 74 74 0 0 0 0 0 0 0 0 0
0 0 74 0 0 5 45 0 0 0 74 0 74 74 126 0 0 0 0 74 74 0 0 0 0 0 0 0 0 0 0
0 0 0 0 6 5 0 0 0 0 0 0 0 126 126 74 0 0 6 74 0 6 0 0 0 0 0 0 0 0 0
0 0 0 74 0 0 0 73 0 0 0 0 74 0 0 126 0 0 0 6 74 0 0 0 0 0 0 0 0 0 0
6 0 0 0 0 0 0 0 183 73 126 0 0 0 0 0 0 0 0 0 0 0 0 0 0 0 0 0 0 0 0
0 0 0 74 0 0 74 0 0 190 0 6 0 0 126 0 0 0 74 74 0 0 6 0 0 0 0 0 0 0 0
0 0 6 6 74 0 0 0 0 190 0 0 74 0 0 0 0 0 74 0 0 0 6 0 0 0 0 0 0 0 0
0 0 6 6 0 74 0 0 0 0 0 74 0 0 0 0 0 0 0 6 6 137 0 0 0 0 0 0 0 0 0
0 0 0 122 0 0 0 190 0 0 0 0 0 0 0 0 0 0 0 137 6 0 0 0 0 0 0 0 0 0 0
0 0 0 0 183 0 0 183 190 0 0 0 0 0 0 0 0 0 6 6 0 6 0 0 0 0 0 0 0 0 0
0 0 0 0 0 0 0 0 0 0 0 0 0 0 0 0 0 0 0 6 0 0 0 0 0 0 0 0 0 0 0
0 0 0 0 0 0 0 0 0 53 0 0 0 0 0 0 0 0 0 0 0 6 0 0 0 0 0 0 0 0 0
0 0 0 0 0 0 0 0 0 0 0 0 0 0 0 0 0 0 0 0 0 0 0 0 0 0 0 0 0 0 0
0 0 122 0 137 0 0 0 0 0 0 0 0 0 0 0 0 0 0 0 0 0 0 0 0 0 0 0 0 0 0
0 0 0 0 0 0 0 0 0 0 0 0 0 0 0 0 0 0 0 0 0 0 0 0 0 0 0 0 0 0 0
0 122 0 0 0 0 0 0 0 0 0 0 0 0 0 0 0 0 0 0 0 0 0 0 0 0 0 0 0 0 0
0 0 0 0 0 0 0 0 0 0 0 0 0 0 0 0 0 0 0 0 0 0 0 0 0 0 0 0 0 0 0
